00$#0000
00$^0000
00$^0000
00$-0000
01222223
04555556
07888889