00000000000000000000000000000000
00000000000000000000000000000000
00000000000000000000000000000000
00000000000000000000000000000000
00000000000000000000000000000000
00000000000000000000000000000000
00000000000000000000000000000000
0!@@@@@#000000000000000000000000
0$%%%%%^001300000000000000000000
0$%%%%%^007900000000000000000000
0$%%%%%^000000000000000000000000
00$%%%^0000000000000000000000000
0000000000000000000~|||||-000000
000000000000000000~:::::/0000000
00000000000000000~::::>/00000000
000000000000000~:::::/0000000000
0000000000000~::::::/00000000000
000~|-0000000>>>>>>/0&2222222223
000+:;00000000000000&!@@@@#55550
000+:;00o0000p00000&5$%%%^555500
01222222222222222225555555555000
04555555555555555556555555550000
0455555555555!@@#556555555500000
04555555555555%%5556555555000000
04555555555555%%5556555550000000