$%%%%%!@@@@@@@@@@@@@@@@@@@@@@@@@@@@@@@@@@@@@@@@@@@@@@@@@@@@@@@@@@@@@@@@@@@@@@@@@@@@@@@@@@@%%%^
$%%%%%^%%%%%%%%%%%%%%%%%%%%%%%%%%%%%%%%%%%%%%%%%%%%%%%%%%%%%%%%%%%%%%%%%%%%%%%%%%%%%%%%%%$%%%^
$%%%%%^0000000000000000000000000000000000000000000000000000000000000000000000000000000000$%%%^
$%%%%%^0000000000000000000000000000000000000000000000000000000000000000000000000000000000$%%%^
$%%%%%^0000000000000000000000000000000000000000000000000000000000000000000000000000000000$%%%^
$%%%%%^0000000000000000000000000000000000000000000000000000000000000000000000000000000000$%%%^
$%%%%%^0000000000000000000000000000000000000000000000000000000000000000000000000000000000$%%%^
$%%%%%^0000000000000000000000000000000000000000000000000000000000000000000000000000000000$%%%^
$%%%%%^0000000000000000000000000000000000000000000000000000000000000000000000000000000000$%%%^
$%%%%%^0000000000000000000000000000000000000000000000000000000000000000000000000000000000$%%%^
$%%%%%^0000000000000000000000000000000000000000000000000000000000000000000000000000000000$%%%^
$%%%%%^0000000000000000000000000000000000000000000000000000000000000000000000000000000000$%%%^
$%%%%!@@@@@@@@@@@@@#000000000000000000000000000000000000000000000000000000000000000000000$%%%^
$%%%%$%%%%%%%%%%%%%^000000000000000000000000000000000000000000000000000000000000000000000$%%%^
$%%%%$%%%%%%%%%%%%%^000000000000000000000000000000000000000000000000000000000000000000000$%%%^
$%%%%$%%%%%%%%%00000000000000000000000000000000000000000000000000000000000000000000000000$%%%^
$%%%%$%%%%%%00000000000000000000000000000000000000000000000000000000000000000000000000000$%%%^
$%%%%%^0000000000000000000000000000000000000000000000000000000000000000000000000000000000$%%%^
$%%%%%^0000000000000000000000000000000000000000000000000000000000000000000000000000000000$%%%^
$%%%%%^0000000000000000000000000000000000000000000000000000000000000000000000000000000000$%%%^
$%%%%%^0000000000000000000000012223000000000000000000000000000000000000000000000000000000$%%%^
$%%%%%^0000000000000000000000000000000000000000000000000000000000000000000000000000000000$%%%^
$%%%%%^00000000000000000000&222222222*000000000000000000000000000000000000000000000000000$%%%^
$%%%%%^0000000000000000000&!@@@@#55555*00000000000000000000000000000000000000000000000000$%%%^
$%%%%%^000000000s00000000&5$%%%^5555555*0000000000000000000000000000000000000000000000000$%%%^
$%%%%%^122222222222222222555555555555555*00000000000000000&22222*000000000000000000000000$%%%^
$%%%%%^4555555555555555556555555555555555*000000000000000&5555555222222222222222222222223$%%%^
$%%%%%^455555555555!@@#556555555555555555522222222222222255555555555555555555555555555556$%%%^
$%%%%%^4555555555555%%5556555555555555555555555555555555555555555555555555555555555555556$%%%^
$%%%%%^4555555555555%%5556555555555555555555555555555555555555555555555555555555555555556$%%%^