00000000
00000000
00000000
00000000
00000000
00000000
00000000
0!@@@@@#
0$%%%%%^
0$%%%%%^
0$%%%%%^
00$%%%^0