0000000000000000000000000000000000000000000000000000000000000000000000000000000000000000000000
$%%%%%!@@@@@@@@@@@@@@@@@@@@@@@@@@@@@@@@@@@@@@@@@@@@@@@@@@@@@@@@@@@@@@@@@@@@@@@@@@@@@@@@@@@%%%^
$%%%%%^%%%%%%%%%%%%%%%%%%%%%%%%%%%%%%%%%%%%%%%%%%%%%%%%%%%%%%%%%%%%%%%%%%%%%%%%%%%%%%%%%%$%%%^
$%%%%%^0000000000000000000000000000000000000000000000000000000000000000000000000000000000$%%%^
$%%%%%^0000000000000000000000000000000000000000000000000000000000000000000000000000000000$%%%^
$%%%%%^0000000000000000000000000000000000000000000000000000000000000000000000000000000000$%%%^
$%%%%%^00000000000000000000000000000000000000000000000000000000000000000000ggggo0gggoggg0$%%%^
$%%%%%^0000000000000000000000000000000000000000000000000000000000000000000&2222222222222223%%^
$%%%%%^00000000000000000000000000000gpg0000000000000000000000000000000000&55555555555555556%%^
$%%%%%^0000000000000000000000000000&222230000000000000000000000000000000&555555555555555556%%^
$%%%%%^000000000000000000000000000&555559000000000000000000000000000000&5555555555555555556%%^
$%%%%%^00000000000000000ggogggogg&5555590gpgg00000000000000000000000000000000000000000000$%%%^
$%%%%%^00000000000000001222222222222222222223000000000000000000p0000000000000000000000000$%%%^
$%%%%%^00o0000p00000000755555!@@@@#55555555590000000000000000!@@@@@0000000000000000000000$%%%^
$%%%%!@@@@@@@@@@@@@#0000788888$%%^8888888889000gogggpggg00000$%%%^00000000000000000000000$%%%^
$%%%%$%%%%%%%%%%%%%!#00000000000000000000000001222222222*0000$%%^0000g0000000000000000000$%%%^
$%%%%$%%%%%%%%%0000$^000000000000000000000000045!@@@#5555*0000000000&2*000000000p00000000$%%%^
$%%%%$%%%%%%0000000$^000000000000000000000000045$%%%^55555*00000000&555*000000!@@@#000000$%%%^
$%%%%%^000000000000$^ggg000000000000000000000045$%%^5555555*gggpgg&55555*g0000$%%^0000000$%%%^
$%%%%%^000000000000$1222300000000000000000000078$%^888888~|||22222555512223000$%^0000gogg$%%%^
$%%%%%^000000000000$4~||000000000000000000000000$^00000000<:;55555555507590000$^0000&222223%%^
$%%%%%^000000000000$79:;00000000000000000000000000000000000+;8888888880080000000000&5555556%%^
$%%%%%^0000000000a0000:;0000ggpgggo000000000000000000000000+;000000000000000000000&55555556%%^
$%%%%%^000000000000000:;000&222222222*0000000000000000000000000000000000000000000&555555556%%^
$%%%%%^000000000000000:;00&!@@@@#55555*00000000000000000000000000000000000000000&5555555556%%^
$%%%%%^ggogggpsggggogg:;0&5$%%%^5555555*0000000000000000000goggg000000000000000&55555555556%%^
$%%%%%^122222222222222222555555555555555*00000000000000000&22222*gggp00pggoggg&555555555556%%^
$%%%%%^4555555555555555556555555555555555*0o00pgggp00o000&555555522222222222222222222222356%%^
$%%%%%^455555555555!@@#55655555555555555552222222222222225555555555555555555555555555555656%%^
$%%%%%^4555555555555%%555655555555555555555555555555555555555555555555555555555555555555656%%^
$%%%%%^4555555555555%%555655555555555555555555555555555555555555555555555555555555555555656%%^
